NO ./textures/wood.xpm
SO ./textures/purplestone.xpm
WE ./textures/pillar.xpm
EA ./textures/wall_2.xpm

F 220,100,0
C 225,30,0

1111111
1000001
1000001
100N001
1000001
1000001
1111111