NO            ./textures/wood.xpm
SO                                                 ./textures/purplestone.xpm
WE      ./textures/pillar.xpm
EA ./textures/wall_2.xpm


F 0,     0,250
C 0,              250,     0


                                    1
     1111111              111111   111
   111000001111     111111000011  10001
  11000N00000011111110000000001    111
 11000000000000000000000011111
1100000111110000000000011       111111111
10000111   111000000111111     111000000011
1000111     1100011111      111000000000111
100011   111111001111111111110000011100001
10001  1111111000001111000000000111  10001
1001  111111100000001100000001111    10001
101 11111110000000011111111111      100111
10011111111000000001111              1001
100111111100000000111        111111110011
10011111100000001111       11000000000011
10001111000000111111     110000000000001
100000000001111111111111110000011111001
100000000111111111000000000011111  1001
11000001111111111100000001111111   1001
 110011111111111100000011111       1001
  10011       11000001111         10001
  1001         11111111         110001
  1001     111111111111111    1100011
  10001  11100000000000001111110001
   1001111000000000000000000000011
    1000000000111111110000000011
    100000011111    11111000111
    11001111           111111
     11111
