NO              ./textures/wood.xpm             
SO          ./textures/purplestone.xpm
WE                                                ./textures/pillar.xpm
EA ./textures/wall_2.xpm

F 0,                      255,                    0
C 0,0,                      200

1111111111111111
1010000000000001
1010000100000111
1010000000010001
1000E00000010001
1111111111111111
