NO ./textures/wood.xpm
SO ./textures/purplestone.xpm
WE ./textures/pillar.xpm
EA ./textures/wall_2.xpm

F 0,0,250
C 0,250,0

1111111111111111111111111111111
1000000000000000000000000000001
1000000000000000000110000000001
1000000000111111100110000000001
1000000000100000000000000000001
1000000111100000000000000000001
1000000000000000000001111110001
1000000000000000000000000010001
1000000111111000000000000010001
1000000100000000000000000010001
1000000100000000000000000010001
1000000100000N00000000000001001
1111111111111111111111111111111
