NO ./textures/wood.xpm

F 220,100,0

                                                    SO ./textures/purplestone.xpm



WE                      ./textures/pillar.xpm
C               225,                    30,                             0
EA ./textures/wall_2.xpm




1111111111111111111111111
1000000000110000000000001
1011000001110000000000001
100100000000000000000000111111111               11111
111111111011000001110000000000001               10011        
100000000011000001110111100111111               11111    
1111011111111101110000001000001
1111011111111101110101001000001
1100000011010101110000001000001
1000000000000000110000001000001
1000000000000000110101001000001
110000011101010111110111100N00111
11110111 1110101 10111101000001
11111111 1111111 1111111111111
