     		    NO 		./textures/mona_lisa.xpm
SO              		./textures/mona_lisa.xpm
WE         ./textures/mona_lisa.xpm				
EA                              ./textures/mona_lisa.xpm

F 51,0,0 
C 0,0,0

1111                                     1
1001
1111
                           1
111111111111   111  1111111
111110001001   101   1101111
100000011001   111     1
111000000001                                         111111
10E000000001                                         1001001
111111000001                                          11 11
110000000001  111111111111111                          1 1
111111111111  100000000000001                          1
              111111111111111111111111
111111
111111
111111
111