NO ./textures/wood.xpm
SO ./textures/purplestone.xpm
WE ./textures/pillar.xpm
EA ./textures/wall_2.xpm

F 0,0,250
C 0,250,0

 1111111111111 1111111111111
 11111100111111111100111111
 11110001111100111110001111
 11000001111000011110000011
 10000000111000011100000001
 10000000000000000000000001
1000000000000000000000000001
1000000000000N00000000000001
 10000000000000000000000001
 10000110001000010001100001
 11001111111100111111110011
 11100111111100111111100111
 11111111111111111111111111
