NO ./textures/wood.xpm
SO ./textures/purplestone.xpm
WE ./textures/pillar.xpm
EA ./textures/wall_2.xpm

F 220,100,0
C 225,30,0

1111111111111        1111111111111111
1000000000001        1010000000000001
1000000000000        1010N00100000111
1000000000001111111100000000100000001
1000000000001        1000000000010001
1111111111111        1111111111111111
