NO ./textures/wood.xpm
SO ./textures/purplestone.xpm
WE ./textures/pillar.xpm
EA ./textures/wall_2.xpm

F 0,255,0
C 0,0,200

111111111111111111
1010000000000000000001
1010000100000100000011111
1010000000010000000001111
1000E00000010000000001
1111111111111111111111
