NO ./textures/wood.xpm
SO ./textures/purplestone.xpm
WE ./textures/pillar.xpm
EA ./textures/wall_2.xpm

F 225,100 
C 220,100,255

1111111111111111
1010000000000001
1010000100000111
10100000N0010001
1000000000010001
1111111111111111
